Name	Type	Nullable
tableoid	oid	false
cmax	cid	false
xmax	xid	false
cmin	cid	false
xmin	xid	false
oid	oid	false
ctid	tid	false
oprname	name	false
oprnamespace	oid	false
oprowner	oid	false
oprkind	"""char"""	false
oprcanmerge	bool	false
oprcanhash	bool	false
oprleft	oid	false
oprright	oid	false
oprresult	oid	false
oprcom	oid	false
oprnegate	oid	false
oprcode	regproc	false
oprrest	regproc	false
oprjoin	regproc	false
