Name	Type	Nullable
tableoid	oid	false
cmax	cid	false
xmax	xid	false
cmin	cid	false
xmin	xid	false
ctid	tid	false
oid	oid	false
datname	name	false
datdba	oid	false
encoding	int4	false
datcollate	name	false
datctype	name	false
datistemplate	bool	false
datallowconn	bool	false
datconnlimit	int4	false
datlastsysoid	oid	false
datfrozenxid	xid	false
datminmxid	xid	false
dattablespace	oid	false
datacl	aclitem[]	true
