Name	Type	Nullable	Default
tableoid	oid	false
cmax	cid	false
xmax	xid	false
cmin	cid	false
xmin	xid	false
oid	oid	false
ctid	tid	false
tgrelid	oid	false
tgname	name	false
tgfoid	oid	false
tgtype	smallint	false
tgenabled	"""char"""	false
tgisinternal	boolean	false
tgconstrrelid	oid	false
tgconstrindid	oid	false
tgconstraint	oid	false
tgdeferrable	boolean	false
tginitdeferred	boolean	false
tgnargs	smallint	false
tgattr	int2vector	false
tgargs	bytea	false
tgqual	pg_node_tree	true
