Name	Type	Nullable	Default
pid	integer	true
usesysid	oid	true
usename	name	true
application_name	text	true
client_addr	inet	true
client_hostname	text	true
client_port	integer	true
backend_start	"timestamp with time zone"	true
backend_xmin	xid	true
state	text	true
sent_lsn	pg_lsn	true
write_lsn	pg_lsn	true
flush_lsn	pg_lsn	true
replay_lsn	pg_lsn	true
write_lag	interval	true
flush_lag	interval	true
replay_lag	interval	true
sync_priority	integer	true
sync_state	text	true
